"The address is One Overlook Court, you'll see it on the left, a little ways after the 50 mile marker on the main road." You stiffen down on the gas pedal, still another few miles. The message continued: "and look, I hope you know how much it means to me that you would come all this way out here tonight.  Things have been really tough for me lately -everything falling apart with John and now my dad's back in the hospital and- well you know. And I mean I know it's just some stupid dinner party for work and it'll probably be really boring- Look. I just want to say thanks; You're a really good friend, and you've kept me going these past few weeks. Uh, so yeah....I'll see you later tonight I guess. " She fumbled with the phone  for a few seconds before finally hanging up.

Ten minutes later you see the 50 mile marker fly by and ease off the gas.  To the left of the road drops away into a deep valley, to the right a woody incline. This was woodsman and redneck country, why a CEO of a fortune 500 company would live here was beyond you. The rain lightens for just a moment and you can make out an old rusted street sign ahead: "Overlook ct".  You slow down and turn right, your tires push off of the wet road and onto the dirt driveway. The path climbs gradually up into the forest, you can see a few tire tracks carved into the muddy road.  Big drops of rain drip off of the canopy of trees above. A few brightly colored leaves dance through the headlights. After about ten minutes of a slow climb, you round the corner to a brilliantly lit stone manor. To the left is a small parking lot, with five cars lined up diagonally. You pull into the free spot at the end, pull your coat over your head as an umbrella and make a quick dash for the door. There is no doorbell but a large polished brass knocker over old mahogany woodwork. You pause for just a second to catch your breath and lift the heavy knocker. After just a few moments, the door is opened and you enter.[ if stuck, try talking to people]
Darkshire Manor
An Interactive Fiction by Cody Chen
Release 1 / Serial number 140319 / Inform 7 build 6G60 (I6/v6.32 lib 6/12N) SD

Lobby
 A butler takes your coat and puts it in the hall closet. "Good evening" He says. "If you would kindly proceed to the parlor, we are waiting on just another guest. Your host will be by shortly." The lobby seems to share the dark wood style of the door, decorative panels coat the outside of the room. A heavy tile floor connects the walls, and above it dangles a giant chandelier.The lobby is a large atruim, it's airspace extends upwards to the second floor. To the west is the parlor, to the northwest is the dining room. Straight ahead to the north is a grand staircase. The doors to the northeast and east and southeast are shut. 

You can see Cellar, a bear door, the head butler and Grand Staircase here.

I beg your pardon?

>ne
You can't go that way.

>nw
Dining room

>se
Lobby
 The lobby is a large entryway that extends upwards to the second floor. To the west is the parlor, to the northwest is the dining room. Straight ahead to the north is a grand staircase. The doors to the northeast and east are shut. 

You can see the head butler here.

* * *

I beg your pardon?

>n
Upstairs

>n
Lobby
 The lobby is a large entryway that extends upwards to the second floor. To the west is the parlor, to the northwest is the dining room. Straight ahead to the north is a grand staircase. The doors to the northeast and east are shut. 

You can see the head butler, Grand Staricase and Billiards Door here.

>n
Upstairs
You can see a Grand staircase here.

>n
Lobby
 The lobby is a large entryway that extends upwards to the second floor. To the west is the parlor, to the northwest is the dining room. Straight ahead to the north is a grand staircase. The doors to the northeast and east are shut. 

You can see the head butler, Grand Staricase and Billiards Door here.

* * *

>n
Upstairs

>nw
Dining room
The dining looks to be modeled after some kind of medival hunting lodge.

* * *

>s
Parlor
You enter the parlor. "You made it!" a voice cries out as you step into the room. Your old friend Sarah comes rushing over and gives you a hug. She is dressed to the nines in high heels and a shimmering crimson dress.  "You made it!" she exclaims, "I was getting worried you might have slid off the road with that storm breweing out there!"

"Ha, no, the driving wasn't bad" you reassure her. "Though I didn't expect to be an 40 miles into the wilderness on a Fridaty.  I'm surprised we even get cell reception out here" "I wouldn't be to sure about that, we're a ways off the main road. Well, let me show you around. Over there's  the Mr Wentworth. He's a business partner, I think he has something to do with my promotion. By the window are Dr Albrecht and Mr Crow. They're going at it right now about the ethical implications of what Albrecht is doing as head of R&D, I wouldn't between them if I were you. 

Parlor has a dark wooden floor, with exquisite furnishings. A bay window overlooks the driveway and another overlooks the valley to the west. 

You can see a bottle of whisky, a bottle of gin, Sarah, Alan Wentworth, Dr Albrecht and David Crow here.

>e
Lobby
 The lobby is a large entryway that extends upwards to the second floor. To the west is the parlor, to the northwest is the dining room. Straight ahead to the north is a grand staircase. The doors to the northeast and east are shut. 

You can see Grand Staricase, Game Door and Cellar here.

>n
Upstairs
You can see the head butler and a Grand staircase here.

>s
Bedroom

>n
Upstairs
You can see the head butler and a Grand staircase here.

>n
Lobby
 The lobby is a large entryway that extends upwards to the second floor. To the west is the parlor, to the northwest is the dining room. Straight ahead to the north is a grand staircase. The doors to the northeast and east are shut. 

You can see Grand Staricase, Game Door and Cellar here.

>n
Upstairs
You can see the head butler and a Grand staircase here.

* * *

>n
Lobby
 The lobby is a large entryway that extends upwards to the second floor. To the west is the parlor, to the northwest is the dining room. Straight ahead to the north is a grand staircase. The doors to the northeast and east are shut. 

You can see Grand Staricase, Game Door and Cellar here.

>se
Basement
You can see cellar Door here.

>se
You can't go that way.

>s
Lobby
 The lobby is a large entryway that extends upwards to the second floor. To the west is the parlor, to the northwest is the dining room. Straight ahead to the north is a grand staircase. The doors to the northeast and east are shut. 

You can see Grand Staricase, Game Door and Cellar here.

>n
Upstairs
You can see the head butler and a Grand staircase here.

>w
Guest suite

>s
You can't go that way.

>e
Upstairs
You can see the head butler and a Grand staircase here.

>s
Bedroom

* * *

>w
Guest suite

>e
Upstairs
You can see the head butler and a Grand staircase here.

>e
The Study

* * *

>n
Upstairs

>w
Parlor

>e
Storage Closet

* * *

I beg your pardon?

>look
Lobby
 The lobby is a large entryway that extends upwards to the second floor. To the west is the parlor, to the northwest is the dining room. Straight ahead to the north is a grand staircase. The doors to the northeast and east are shut. 

You can see the head butler, Grand Staricase, Billiards Door and If butler here.

* * *

I beg your pardon?

>l
Lobby
 The lobby is a large entryway that extends upwards to the second floor. To the west is the parlor, to the northwest is the dining room. Straight ahead to the north is a grand staircase. The doors to the northeast and east are shut. 

You can see the head butler, Grand Staricase, Game Door and Cellar here.

>w
Parlor
You enter the parlor. "You made it!" a voice cries out as you step into the room. Your old friend Sarah comes rushing over and gives you a hug. She is dressed to the nines in high heels and a shimmering crimson dress.  "You made it!" she exclaims, "I was getting worried you might have slid off the road with that storm breweing out there!"

"Ha, no, the driving wasn't bad" you reassure her. "Though I didn't expect to be an 40 miles into the wilderness on a Fridaty.  I'm surprised we even get cell reception out here" "I wouldn't be to sure about that, we're a ways off the main road. Well, let me show you around. Over there's  the Admiral 

Parlor has a dark wooden floor, with exquisite furnishings. A bay window overlooks the driveway and another overlooks the valley to the west. 

You can see a bottle of whisky, a bottle of scotch, Sarah, Mr Wentworth, Dr Albrecht and David Crow here.

>drink
What do you want to drink?

>take drink
Which do you mean, the whisky or the scotch?

>drink whisky
There's nothing suitable to drink here.

>take whisky
You pour yourself a drink

>take whisky
You pour yourself a drink

>take whisky
You think you've had enough for now

>drink whisky
There's nothing suitable to drink here.

* * *

>l
Lobby
 The lobby is a large entryway that extends upwards to the second floor. To the west is the parlor, to the northwest is the dining room. Straight ahead to the north is a grand staircase. The doors to the northeast and east are shut. 

You can see the head butler, Grand Staricase, Game Door and Cellar here.

>nw
Dining room
The dining looks to be modeled after some kind of medival hunting lodge.

>l
Dining room
The dining looks to be modeled after some kind of medival hunting lodge.

* * *

>l
Dining room
The dining looks to be modeled after some kind of medival hunting lodge.

>l
Dining room
The dining looks to be modeled after some kind of medival hunting lodge.

* * *

I beg your pardon?

>e
The Butler stops you and says "That is a Closet. Wait in the parlor please".

>look
Lobby
 The lobby is a large entryway that extends upwards to the second floor. To the west is the parlor, to the northwest is the dining room. Straight ahead to the north is a grand staircase. The doors to the northeast and east are shut. 

You can see the head butler, Grand Staricase, Billiards Door and If the butler here.

>ne
The Butler stops you and says "The parlor please".

* * *

>e
The Butler stops you and says "That is a Closet. Wait in the parlor please".

>ne
The Butler stops you and says "After dinner drinks are in the Game Room. The parlor please".

>s
You can't go that way.

>w
Parlor
You enter the parlor. "You made it!" a voice cries out as you step into the room. Your old friend Sarah comes rushing over and gives you a hug. She is dressed to the nines in high heels and a shimmering crimson dress.  "You made it!" she exclaims again, "I was getting worried you might have slid off the road with that storm brewing out there!"

"Ha, no, the driving wasn't bad" you reassure her. "Though I didn't expect to be an 40 miles into the wilderness on a Friday.  I'm surprised we even get cell reception out here" "Well as the newly promoted head of marketing for Universal Cell towers incorperated, you have me to thank for that." she said smugly. "Well, let me show you around. Over there's  the Mr Wentworth. He's the second in comand, behind Mr. Vectim.  I think he has something to do with my promotion. By the window are Dr Albrecht and Mr Crow. Alrbecht is head of R&D, she can be a bit scary at times. Crow is this big time investor, I don't know too much about him except that he's really old money. They're going at it right now about the ethical implications of what Albrecht is doing as head of R&D, I wouldn't between them if I were you. 
Parlor has a dark wooden floor, with exquisite furnishings. A bay window overlooks the driveway and another overlooks the valley to the west. To the north is the dining room, to the east is the lobby.

You can see a bottle of whisky, a bottle of gin, a liquor cabinet (closed), a couch, Alan Wentworth, Dr Albrecht and David Crow here.

>n
Dining room
 You and sarah talk for a long time, catching up on each others" lives.  After a while, you both get hungry and decide to seek out the other guests and your host.The dining looks to be modeled after some kind of medival hunting lodge. Insead of a fancy candlelit table is what appears to be a banquet hall.

>s
Parlor
Parlor has a dark wooden floor, with exquisite furnishings. A bay window overlooks the driveway and another overlooks the valley to the west. To the north is the dining room, to the east is the lobby.

You can see a bottle of whisky, a bottle of gin, a liquor cabinet (closed), a couch, Alan Wentworth, Dr Albrecht and David Crow here.

A bolt of thunder cracks down right outside. With a crack and a fizz the lights quickly dim into darkness.  The room explodes in gasps, and then silence. Aside from the storm, all is quiet. 

Dr Albrecht's voice cuts in with in her thick german accent: "Oh no, oh no no no, I  hate  the dark.  I'll be in my car until the lights turn back on." she said, fumbling her way out the door. "Butler?" you hear her call though the door. "Oh where has that man gone?" she mumbles as the front door creeks open and shut. 
Sarah pipes up and says, "don't worry, we'll get the lights back on." Mr. Wentworth gets up and says "That sounds lovely, I'll wait in the dining room, there's light from the fire in there." he leaves. David crow says "I think I'll go check on Mr. Vectim, he sure is taking his time."

>w
You can't go that way.

>ne
You can't go that way.

>e
Lobby
 The lobby is a large entryway that extends upwards to the second floor. To the west is the parlor, to the northwest is the dining room. Straight ahead to the north is a grand staircase. The doors to the northeast and east are shut. 

You can see a Bear door, Grand Staricase and Cellar here.

>ne
game room
You can see a Bear door here.

You must supply a noun.

You must supply a noun.

* * *

I beg your pardon?

>s
You've only just arrived, Stay a while.

>w
Parlor
You enter the parlor. "You made it!" a voice cries out as you step into the room. Your old friend Sarah comes rushing over and gives you a hug. She is dressed to the nines in high heels and a shimmering crimson dress.  "You made it!" she exclaims, "I was getting worried you might have slid off the road with that storm breweing out there!"

"Ha, no, the driving wasn't bad" you reassure her. "Though I didn't expect to be an 40 miles into the wilderness on a Fridaty.  I'm surprised we even get cell reception out here" "I wouldn't be to sure about that, we're a ways off the main road. Well, let me show you around. Over there's  the Admiral 

Parlor has a dark wooden floor, with exquisite furnishings. A bay window overlooks the driveway and another overlooks the valley to the west. 

You can see a bottle of whisky, a bottle of scotch, Sarah, Mr Wentworth, Dr Albrecht and David Crow here.

>accuse sarah
"I don't know how to say this Sarah, but I think you did it. All the evidence points to you. "

>accuse Wentworth
"I don't know how to say this Sarah, but I think you did it. All the evidence points to you. "

>accuse
You must supply a noun.

>accuse Mr wentworth
"I don't know how to say this Sarah, but I think you did it. All the evidence points to you. "

>accuse self
"I don't know how to say this Sarah, but I think you did it. All the evidence points to you. "

>accuse a
You can't see any such thing.

>accuse wine
You can't see any such thing.

>accuse scotch
You can't see any such thing.

>l
Parlor

Parlor has a dark wooden floor, with exquisite furnishings. A bay window overlooks the driveway and another overlooks the valley to the west. 

You can see a bottle of whisky, a bottle of scotch, Sarah, Mr Wentworth, Dr Albrecht and David Crow here.

>accuse bottle of scoth
You can't see any such thing.

>accuse scotch
You can't see any such thing.

>accuse bottle of scotch
You can't see any such thing.

>take scotch
You pour yourself a drink

>take scotch
You pour yourself a drink

>take scotch
You think you've had enough for now

>take whisky
You pour yourself a drink

* * *

I beg your pardon?

>w
Parlor
You enter the parlor. "You made it!" a voice cries out as you step into the room. Your old friend Sarah comes rushing over and gives you a hug. She is dressed to the nines in high heels and a shimmering crimson dress.  "You made it!" she exclaims again, "I was getting worried you might have slid off the road with that storm brewing out there!"

"Ha, no, the driving wasn't bad" you reassure her. "Though I didn't expect to be an 40 miles into the wilderness on a Friday.  I'm surprised we even get cell reception out here" "Well as the newly promoted head of marketing for Universal Cell towers incorperated, you have me to thank for that." she said smugly.  "A promotion!" you exclaim, "You never said you were getting promoted! and head of marketing, wow. Well you've certainly showed me." "Well yeah" she said, why else do you think I was able to invite you here tonight? I mean, it was supposed to be john here tonight, but forget him. Well, let me show you around. Over there's  the Mr Wentworth. He's the second in comand, behind Mr. Vectim.  I think he has something to do with my promotion. By the window are Dr Albrecht and Mr Crow. Alrbecht is head of R&D, she can be a bit scary at times. Crow is this big time investor, I don't know too much about him except that he's really old money. They're going at it right now about the ethical implications of what Albrecht is doing as head of R&D, I wouldn't between them if I were you. 

Parlor has a dark wooden floor, with exquisite furnishings. A bay window overlooks the driveway and another overlooks the valley to the west. To the north is the dining room, to the east is the lobby.

You can see a bottle of whisky, a bottle of gin, a liquor cabinet, Sarah Kenter, Alan Wentworth, Dr Albrecht and David Crow here.

>take scotch
You pour yourself a drink